app	sqobj/app.gsb
SceneBase	sqobj/SceneBase.gsb
scene_common	sqobj/scene_common.gsb
ActorBase	sqobj/ActorBase.gsb
GenericNpc	sqobj/GenericNpc.gsb
QuestNpc	sqobj/QuestNpc.gsb
EncounterNpc	sqobj/EncounterNpc.gsb
VendorNpc	sqobj/VendorNpc.gsb
DemoEventBase	sqobj/DemoEventBase.gsb
SaveObjActor	sqobj/SaveObjActor.gsb
Scarab	sqobj/Scarab.gsb
CameraEventControl	sqobj/CameraEventControl.gsb
BgobjActorBase	sqobj/BgobjActorBase.gsb
EventResponderActor	sqobj/EventResponderActor.gsb
BreakableActor	sqobj/BreakableActor.gsb
BreakableWallActor	sqobj/BreakableWallActor.gsb
RoomObjActor	sqobj/RoomObjActor.gsb
SandpileActor	sqobj/SandpileActor.gsb
SwitchObjActor	sqobj/SwitchObjActor.gsb
SwitchMonitorActor	sqobj/SwitchMonitorActor.gsb
PortalActor	sqobj/PortalActor.gsb
ChaosGrassActor	sqobj/ChaosGrassActor.gsb
RespawnObjActor	sqobj/RespawnObjActor.gsb
DieObjActor	sqobj/DieObjActor.gsb
RoadObjActor	sqobj/RoadObjActor.gsb
KoujiMan	sqobj/KoujiMan.gsb
EvCommon	sqobj/EvCommon.gsb
EvUa_01	sqobj/EvUa_01.gsb
EvIkune_01	sqobj/EvIkune_01.gsb
EvCeruke_01	sqobj/EvCeruke_01.gsb
Ebio	sqobj/Ebio.gsb
Eseherc	sqobj/Eseherc.gsb
Kaera	sqobj/Kaera.gsb
Miu	sqobj/Miu.gsb
OldmanCeruke	sqobj/OldmanCeruke.gsb
OldmanRikos	sqobj/OldmanRikos.gsb
OldmanUa	sqobj/OldmanUa.gsb
ui_choice	sqobj/ui_choice.gsb
